Level_3
0000000000000000
0x___00_______x0
0______________0
0_______0______0
0__0________0__0
0______________0
0111111__1111110
01111110_1111110
0111111__1111110
0__________00__0
0______________0
0______0_______0
0__0___________0
0______bb______0
0______bb__0___0
0000000000000000
