Level_1
0000000000000000
0__x__0__0__x__0
0_1_1_0__0_1_1_0
0_1_1______1_1_0
0_1_111__111_1_0
0_1_1______1_1_0
0______________0
0____11__11____0
0____11__11____0
0______________0
0_1_1______1_1_0
0_1_1______1_1_0
0_1_1_2222_1_1_0
0_1_1_2bb2_1_1_0
0_____2bb2_____0
0000000000000000