Level_1
0000000000000000
0_____0__0_____0
0_1_1_0__0_1_1_0
0_1_1_0000_1_1_0
0_1_1______1_1_0
0_1_1______1_1_0
0______________0
0____22__22____0
0____22__22____0
0______________0
0_1_1______1_1_0
0_1_1______1_1_0
0_1_1_0000_1_1_0
0_1_1_0__0_1_1_0
0_____0__0_____0
0000000000000000