Level_1
0000000000000000
0_____0__0_____0
0_____0000_____0
0______________0
0______________0
0______________0
0______________0
0______________0
0______________0
0______________0
0______________0
0______________0
0______________0
0_____0000_____0
0_____0__0_____0
0000000000000000