Level_2
0000000000000000
0______________0
01111__1_1___1_0
01__1__1_1___1_0
01__1__1__1_1__0
01111__1__1_1__0
01_____1___1___0
01__1__1___1___0
01__1111_______0
0______________0
0______________0
0______________0
0______________0
0______________0
0______________0
0000000000000000