Level_2
0000000000000000
0_____________x0
01111__1_1___1_0
01__1__1_1___1_0
01__1__1_1___1_0
01111__1__1_1__0
01_____1__1_1__0
01__1_x1__1_1__0
01__1111___1___0
0______________0
0______________0
0______________0
0______________0
0______bb______0
0______bb______0
0000000000000000