Level_3
0000000000000000
0111111111111110
0111111111111110
0111111111111110
0111111111111110
0111111111111110
0111111111111110
0111111111111110
0111111111111110
0111111111111110
0111111111111110
0111111111111110
01111_111111_110
0111111bb1111110
0111111bb1111110
0000000000000000
